;0
##########
#    ....#
#  # $$$$#
## #     #
#  #######
# ###    #
#        #
#### #####
#### @####
##########