;0
##########
#    ....#
#  # $$$$#
## #     #
#  ### ###
# ###    #
#        #
#### #####
#### @####
##########